NO ./textures/wood.xpm
SO ./textures/wood_box.xpm
WE ./textures/wood.xpm
EA ./textures/wood.xpm
F 0,0,255
C 0,255,0
        1111111111111111111111111
        1000000000110000000000001
        1011000001110000000000001
        1000000000000000000000001
111111111011000001110000000000001
110000000011000001110111101111111
11110011111111011100000010001
11110011111111011101010010001
11000000110101011100000010001
1000000000000000000000010001
1000000010000001001001000001
11000001110101011111011110W0111
11110111 1110101 101000000001
11111111 1111111 111111111111